
wwwwwwwwwwwwww      wwwwwwwwwwwwww
w     m          h    www       ww
w      wwwwwwwwwwwwwwwww   m     w
w  m  ww        w m   w   w      w
www  www    ww  w  w  w  ww   m  w
w   www      w  w  w  w  w       w
ww  w        w  w  w  w  w  k    w
w m w   m    w     w m   ww      w
w  www       wwwwwwwwwwwwwww     w
w   wwwww         www       m   ww
w      ww  k      www  m       www
w  mwwwww    wwwwwwww     wwwwwwww
w       w        wwwww     m
w  k    w  m       wwww       m
wwwww   w           wwwwwwwwwwwwww
w  m   www     m    m    m       w
w     wwwwwwwww    w    w    w   w
w     w      wwww  w  www    w www
w m  ww  ww   w m  w    www  w m w
w    w    w   www  w m  w    w   w
w   ww k  w k w  m w    w m  w   w
w  www    w   w  www    w  wwww  w
w         ww         m           w
wwwwwwwwwwwwwwwwwwwwwwwwwwwwwwwwww