
wwwwwwwwwwwwww      wwwwwwwwwwwwww
w       k       m     www       ww
w      wwwwwwwwww      w    m    w
w  m  ww        ww    ww   w     w
w    www    ww  wwwwwwww   w     w
w   www      w  w   w      w     w
w   w        w w  w   m    w  k  w
w   w   m    w    w   k   ww     w
w   ww       wwwwwwwwwwwwwww     w
w   wwwww         www           ww
w      ww  k       w   m  m    www
w  m    w    wwwwwwww     wwwwwwww
w       w        wwwww          h
w  k    w  m       wwww
w       w           wwwwwwwwwwwwww
w  m   www     m                 w
w     wwwwwwwww    w    w    w   w
w     w      ww    w  www    w www
w    ww  ww   w m  w    www  w m w
w    w    w   www  w m  w    w   w
w   ww k  w k w    w    w m  w   w
w  www    w   w  www    w  wwww  w
w         ww         m           w
wwwwwwwwwwwwwwwwwwwwwwwwwwwwwwwwww