
wwwwwwwwwwwwwwwwwwwwwwwwwwwwwwwwww
w                                w
w               w                w
w  k            w                w
w               w                w
w               w         k      w
w               w                w
w               w                w
w       m       w                w
w               w                w
w                                w
w                                w
w                                w
w                                w
w             m                  w
w                                w
w               w          m     w
w               w                w
w               w                w
w      h        w                w
w               w                w
w               w                w
w               w                w
wwwwwwwwwwwwwwwwwwwwwwwwwwwwwwwwww