
wwwwwwwwwwwwwwwwwwwwwwwwwwwwwwwwww
w                                w
w                       w        w
w      m                w        w
w         w             w   m    w
w         w           k w        w
w         wwwwwwwwwwwwwww        w
w         w                      w
w    m    w      m      w        w
w         w             wwwwww   w
w         w             w k      w
w         w       m     w        w
  h       w             w        w
          w    k        w   m    w
wwwwwwwwwww             w        w
w                       w        w
w        wwwwwwwwwwwwwwww        w
w        w              k        w
w     m  w           w           w
w        w     m     w           w
w        w           w     m     w
w                    w           w
w     m              w           w
wwwwwwwwwwwwwww    wwwwwwwwwwwwwww