
wwwwwwwwwwwwwwwwwwwwwwwwwwwwwwwwww
w                                w
w               ww               w
w               ww               w
w               ww               w
w              wwww              w
w             wwwwww             w
w            www  www            w
w           www    www           w
w          www   k  www          w
w         www        www         w
w        www     m    www
w        www     m    www
w         www        www         w
w          www   k  www          w
w           www    www           w
w            www  www            w
w             wwwwww             w
w              wwww              w
w               ww               w
w      h        ww               w
w               ww               w
w               ww               w
wwwwwwwwwwwwwwwwwwwwwwwwwwwwwwwwww