
wwwwwwwwwwwwwwwwwwwwwwwwwwwwwwwwww
wkw   wkw   wkw   wkw   wkw      w
wkw   wkw   wkw   wkw   wkw      w
wkw   wkw   wkw   wkw   w w      w
wkw   wkw   wkw   w w   w w      w
wkw   wkw   w w   w w   w w      w
wkw  ww ww ww ww ww ww ww ww     w
w wwww   www   www   www   wwwwwww
w                              www
w  www   www   www   www        ww
w  w ww ww ww ww ww ww ww ww     w
w  w  wkw   wkw   w w   w ww     w
 h w  wkw   wkw   wkw   w ww
 www  wkw   wkw   wkw   wkwww
ww    wkw   wkw   wkw   wkwwww   w
wwwwwwwwwwwwwwwwwwwwwwwwwwwwwwwwww
w                                w
w  wwwwww  w     w  w    w   w   w
w  w    w  w     w  ww   w   w   w
w  wwwwww  w     w  w w  w   w   w
w  w w     w     w  w  w w       w
w  w  w    wwwwwww  w   ww   w   w
w                                w
wwwwwwwwwwwwwwwwwwwwwwwwwwwwwwwwww